11,19
5,5,5,5,5,5,5,5,5,5,5,5,5,5,5,5,5,5,5
5,4,6,6,6,6,6,6,6,2,6,6,6,6,6,6,6,3,5
5,6,5,5,5,5,6,5,5,6,5,5,5,5,6,6,5,6,5
5,6,6,5,5,6,6,5,5,6,5,5,5,5,6,5,5,6,5
5,6,6,6,6,6,6,6,6,6,6,6,6,6,6,6,6,6,5
5,6,5,5,5,5,5,5,5,6,5,5,5,5,5,5,5,6,5
5,6,6,6,6,6,6,6,6,6,6,6,6,6,6,6,6,6,5
5,6,5,5,5,5,6,5,5,6,5,5,5,5,6,6,5,6,5
5,6,6,5,5,6,6,5,5,6,5,5,5,5,6,5,5,6,5
5,1,6,6,6,6,6,6,6,6,6,6,6,6,6,6,6,6,5
5,5,5,5,5,5,5,5,5,5,5,5,5,5,5,5,5,5,5