6,19
5,5,5,5,5,5,5,5,5,5,5,5,5,5,5,5,5,5,5
5,6,6,6,6,6,6,6,6,6,6,4,6,6,6,6,6,6,5
5,6,5,5,5,5,6,5,5,6,5,5,5,5,6,6,5,6,5
5,2,6,5,5,6,6,5,5,6,5,5,5,5,6,5,5,6,5
5,1,6,6,6,6,6,6,6,6,6,6,6,6,6,6,3,6,5
5,5,5,5,5,5,5,5,5,5,5,5,5,5,5,5,5,5,5